1,0,1,2,1,1,1
5,5,5,5,1,2,1
1,2,1,5,3,2,1
1,2,1,5,3,2,1
1,2,1,5,2,2,6,
1,1,1,5,1,1,7
1,4,1,1,1,1,7
1,4,1,1,1,1,7
1,4,1,1,1,1,1